2222222222222222222222222222222222222222222222222222222222222222222222222222222222222222222222222222222222222222
2000000000200000000000000000000000000000000000000000000000000000000000000000000000000000000000000000000000000000
2000000000200000000000000000000000000000000000000000000000000000000000000000000000000000000000000000000000000000
2000000000200000000000000000000000000000000000000000000000000000000000000000000000000000000000000000000000000000
2000000000200000000000000000200000000000000000000000000000000000000000000000000000000000000000000000000000000000
2000000000200000000000000000200000000000000000000000000000000000000000000000000000000000000000000000000000000000
2000000000022220000000000000022222222000000000000000003000222222200000000000000000300022222220000000000000000030
2000000000000222200000000000020000000000022220000000003000000000000002222000000000300000000000000222200000000030
2022222222220000000222222222222222220000000000022220003000000000000000000002222000300000000000000000000222200030
0000000022222220000000000000000000002222000000000000030000000000222200000000000003000000000022220000000000000300
0000000000000022222222000030000000000000000000000000003000000000000000000000000000300000000000000000000000000030
1111111111111111111111111111111111111111111111111111111111111111111111111111111111111111111111111111111111111111