22222222222222222222222222222222222222222222222222222222222222222222222222222222222222222222222222222222222222222222222222222222222222222222222222222222222222222222222222222222222222222222222222222222222222222222222222222222222222222222222222222222222222222222222222222222222222222222222222222222222222222222222222222222222222222222222222222222222222
20000000000000000000000000000000000000000000000000000000000000000000000000000000000000000000000000000000000000000000000000000000000000000000000000000000000000000000000000000000000000000000000000000000000000000000000000000000000000000000000000000000000000000000000000000000002220000000022002002202000000000000000000000000220000000000030000000000000002
20000000000000000000000000000000000000000000000000000000000000000000000000000000000000000000000000000000000000000000000000003000000000000000000000000000000000000000000000000000000000000000000000000000000000000000000000000000000000000000000000000000000000000000000000000000000000000000000020000000000000000000300000300000000000000000000000000000000002
20000000000000000000000000000000000000000000000000000000000000000000000000000000000000000000000000000000000000000000000004002000000000000000000400000000000000003000000000000000000000002220000000000000000000000000000000000000000000000000000000000000000000000000000000000000000000000000000000200000000000400000200000000000003000000000044000000000000002
20000000000004000000000000000000000000000000000000000000000000000000000000000000000000040000000000000000000000000040000002200000000000000000000000000000000000302000000000000000000000000000000000000000000000000000000000000400000000000000000000000003000000000000000000000000000000000000000000002000000000000000200000000000222220000000022000000000000002
20000000000000000000000000000000000000000004000000040000000000400000000000000000003000004430000000000000000000320000000000000000000000003004000000000000004000200000000000000004000000000000000000000000000000000000000000002222000000000000000000000022220000003000000000000000000000000000000000000000000000000200000000000000000000000000000000000000000202
20000000000222200000000000000000000000000000000000000020002222222000000400000000002000222222200000400000000000220000000000000000000000022222222220000000000000200000000000040002000000000000000000000000000000000000040000000000000000000000000000004000000042222200000000000030030000000000000020000004000000002000000000002200000000000000000000000000002002
20000000000000000004003000000000300000000222200030000020000000000000022220000400002000000000000002222000300000220000220000000000020000000000000000000000000004220000000000000000200000000000000000000000000000000000022200000000000000000000004000042222222222000000000000000022222000000000002000000000000000020000000000000003000000000000000000000000320002
20222222222200000002222222222222222200000000000222200020000300000300000000022220002000000300000000000002222000220000000000000000000000000000000000000000020002222000000000300000000000000000000000040000000000000000000002300000000000000000000000220000000000000000000000000000000000000000000000000000000022200000000000000022000000300000000000000002200002
00000000222222230000000000000000000022220000000000222222222222222222002222222222222222222222220022222222222202220000000000000400000000000030000000000000000000000000003000220000000000000000000002222222222220000000000000200000000000000030000000000000000000000000000300000000000000000004000000000222200000000000000000000000000000200000333300444000000002
00000000000000222222220000200000000000000000000000000020000000000000000000000000002000000000000000000000000000200000000000002200000000002222000000000040002000022222222020000000000000000040000000000000000000000000000000000000000000000022200000000000000000000000222222200000000000000022000000000000000000000000000000000000000000000002222222222200000002
11111111111111111111111111111111111111111111111111111111111111111111111111111111111111111111111111111111111111111111111111111111111111111111111111111111111111111111111111111111111111111111111111111111111111111111111111111111111111111111111111111111111111111111111111111111111111111111111111111111111111111111111111111111111111111111111111111111111112