0000000000000000000000000000000000000000000000000000000000000000000000000000000000000000000000000000000000000000
0000000000000000000000000000000000000000000000000000000000000000000000000000000000000000000000000000000000000000
0000000000000000000000000000000000000000000000000000000000000000000000000000000000000000000000000000000000000000
0000000000000000000000000000000000000000000000000000000000000000000000000000000000000000000000000000000000000000
0000000000000000000000000000000000000000000000000000000000000000000000000000000000000000000000000000000000000000
0000000000000000000000000000000000000000000000000000000000000000000000000000000000000000000000000000000000000000
0222222200000000000000000300022222220000000000000000030002222222000000000000000003000222222200000000000000000300
0000000000002222000000000300000000000000222200000000030000000000000022220000000003000000000000002222000000000300
0000000000000000002222000300000000000000000000222200030000000000000000000022220003000000000000000000002222000300
0000000022220000000000000300000000002222000000000000030000000000222200000000000003000000000022220000000000000300
0000000000000000000000000300000000000000000000000000030000000000000000000000000003000000000000000000000000000300
1111111111111111111111111111111111111111111111111111111111111111111111111111111111111111111111111111111111111111