2222222222222222222222222222222222222222222222222222222222222222222222222222222222222222222222222222222222222222
2000000000200000000000000000000000000000000000000000000000000000000000000000000000000000000000000000000000000002
2000000000200000000000000000000000000000000000000000000000000000000000000000000000000000000000000000000000000002
2000000000200000000000000000000000000000000000000000000000000000000000000000000000000000000000000000000000000002
2000000000200000000000000000000000000000000000000000000000000000000000000000000000000000000000000000000000000002
2000000000200000000000000000000000000000000000000000000000000000000000000000000000000000000000000000000000000002
2000000000022220000000000000000000000000000000000000002000222222200000000000000000200022222220000000000000000022
2000000000040000000400000000000000000000022220000000002000000000000002222000000000200000000000000222200000000022
2022222222220000000222222222222222220000000000022220002000000000000000000002222000200000000000000000000222200022
0000000022222220000000000000000000002222000000000022222222222222222222222222222222222222222222222222222222222222
0000000000000022222222000020000000000000000000000000002000000000000000000000000000200000000000000000000000000020
1111111111111111111111111111111111111111111111111111111111111111111111111111111111111111111111111111111111111111